1233111121
2        1
2311131  2
1        1
4  1  1213
4432  3  4
1  1  1  4
3       11
4  1  2  4
4421112344